EEEEEEEEEEEEEEEEEEEEEEEEEEEE
EEEEEEEEEEEEEEEEEEEEEEEEEEEE
EEEEEEEEEEEEEEEEEEEEEEEEEEEE
WWWWWWWWWWWWWWWWWWWWWWWWWWWW
WDDDDDDDDDDDDWWDDDDDDDDDDDDW
WDWWWWDWWWWWDWWDWWWWWDWWWWDW
WSWWWWDWWWWWDWWDWWWWWDWWWWSW
WDWWWWDWWWWWDWWDWWWWWDWWWWDW
WDDDDDDDDDDDDDDDDDDDDDDDDDDW
WDWWWWDWWDWWWWWWWWDWWDWWWWDW
WDWWWWDWWDWWWWWWWWDWWDWWWWDW
WDDDDDDWWDDDDWWDDDDWWDDDDDDW
WWWWWWDWWWWWEWWEWWWWWDWWWWWW
EEEEEWDWWWWWEWWEWWWWWDWEEEEE
EEEEEWDWWEEEEEEEEEEWWDWEEEEE
EEEEEWDWWEWWWWWWWWEWWDWEEEEE
WWWWWWDWWEWEEEEEEWEWWDWWWWWW
TTTTTTDEEEWEEEEEEWEEEDTTTTTT
WWWWWWDWWEWEEEEEEWEWWDWWWWWW
EEEEEWDWWEWWWWWWWWEWWDWEEEEE
EEEEEWDWWEEEEEEEEEEWWDWEEEEE
EEEEEWDWWEWWWWWWWWEWWDWEEEEE
WWWWWWDWWEWWWWWWWWEWWDWWWWWW
WDDDDDDDDDDDDWWDDDDDDDDDDDDW
WDWWWWDWWWWWDWWDWWWWWDWWWWDW
WDWWWWDWWWWWDWWDWWWWWDWWWWDW
WSDDWWDDDDDDDEEDDDDDDDWWDDSW
WWWDWWDWWDWWWWWWWWDWWDWWDWWW
WWWDWWDWWDWWWWWWWWDWWDWWDWWW
WDDDDDDWWDDDDWWDDDDWWDDDDDDW
WDWWWWWWWWWWDWWDWWWWWWWWWWDW
WDWWWWWWWWWWDWWDWWWWWWWWWWDW
WDDDDDDDDDDDDDDDDDDDDDDDDDDW
WWWWWWWWWWWWWWWWWWWWWWWWWWWW
EEEEEEEEEEEEEEEEEEEEEEEEEEEE
EEEEEEEEEEEEEEEEEEEEEEEEEEEE
